b - boss
	ars - ares final laser
	atm - artemis final laser
	brm - brimstone laser
	brmh - brimstone laser hint
	dfl - dragonfolly
	dvt - DoG trail windup
	eld - empress lance - day
	eln - empress lance - night
	elwd - empress lance windup day
	elwn - empress lance windup night
	gdn - guardian laser
	mdr - moonlord death ray (true eye of cthulhu)
	mdrm - moonlord death ray (major)
	pvd - providence laser
	tnt - thanatos
	yrn - yharon
m - misc
	trp - terraprisma
p - potion
	bl - bleeding
	bn - burning
	ci - cursed inferno
	em - elemental mix
	fb - forstburn
	gi - god slayer inferno
	hf - hallow fire
	mb - miracle blight
	sf - shadow flame
t - trail
	atl - atlantis
	ntb - nettle burst
	oll - orange large lasers
	rll - red large lasers
	bls - blue lasers
	dbls - dark blue lasers
	lls - lime lasers
	ols - orange lasers
	rls - red lasers
	gls - green lasers
	pls - purple lasers
	pkls - pink lasers
	rbws - rinbow (laser style)
	rt - red trail (narrower than lasers)
	ot - orange trail (narrower than lasers)
	dgt - dark green trail (narrower than lasers)
	gt - green trail (narrower than lasers)
	bt - blue trail (narrower than lasers)
	pt - purple trail (narrower than lasers)
	pkt - pink trail (narrower than lasers)
	yt - yellow trail (narrower than lasers)
	rbwt - rinbow (trail style)